[otc-ruchi]
Yongfeng Du: dolpherdu
Shaohe Feng: shaohef
Yongli He: yongli-he
yuntongjin: yuntongjin
Eli Qiao: taget-9
tanlin: tan-lin-good
Alex Xu: xuhj
yang lin: lin-a-yang
zang rui: rui-zang
zhang lei: lei-a-zhang
yalei-wang: yalei-wang

mahati-chamarthy: mahati-chamarthy
wei-d-chen: wei-d-chen
Cheng Ying xin: cyx1231st
Ruijing: ruijing-guo
Li xiaoyan: lisali
lianhao, Lu: lianhao-lu
Xin, xiaohui: xiaohui-xin
edwin-zhai: edwin-zhai
Ren qiaowei: qiaowei-ren
ganesh-mahalingam: ganesh-mahalingam

Isaku Yamahata: yamahata

malini-k-bhandaru: malini-k-bhandaru

manjeet-s-bhatia: manjeet-s-bhatia
David Chou: david-j-chou
John Hinman: john-hinman
pramod-raghavendra-jayathirth: pramod-raghavendra-jayathirth
Mohammed Z Malick: mohammed-zaheeruddin-malick
Nate Potter: ntpttr
Deepti Ramakrishna: dramakri
manjunath-ranganathaiah: manjunath-ranganathaiah
dileep-ranganathan: dileep-ranganathan
ritu-sood: ritu-sood
ning-sun: ning-sun
